107
12
22 4 0 0 0 9 0 0 0 0 0 0 0 0 0 0 0 0 0 0 0 0 0 0 0 0 0 0 0 0 0 0 0 0 0 0 0 0 0 0 0 0 0 0 3 22 22 22 22 22 22 22 22 22 4 3 22 22 4 0 0 0 3 22 22 22 22 22 22 22 22 22 22 22 4 0 0 0 0 0 0 0 0 0 0 0 3 22 22 22 22 22 22 22 22 22 22 22 22 22 22 22 22 22 22 22 22 
22 4 0 23 24 24 25 0 0 0 0 0 0 0 0 0 0 0 0 0 0 0 0 0 0 0 0 0 0 0 0 0 0 0 0 0 0 0 0 0 0 0 0 0 0 18 22 22 22 22 19 17 17 17 0 0 17 17 0 0 0 0 0 17 17 18 22 22 22 22 19 17 17 17 0 0 0 0 0 0 0 0 0 0 0 0 0 18 22 22 22 22 22 22 22 22 22 22 22 22 22 22 22 22 22 22 22 
22 4 0 0 0 0 0 0 0 0 0 0 0 0 0 0 0 0 0 0 0 0 0 0 0 0 0 0 0 0 0 0 0 0 0 0 0 0 0 0 0 1 21 21 2 0 17 18 22 19 0 0 0 0 0 0 0 0 0 0 0 0 0 0 0 3 22 19 17 17 1 21 8 21 21 2 0 0 0 0 0 0 0 0 0 0 0 0 18 22 22 22 22 22 22 22 22 22 22 22 22 22 22 22 22 22 22 
22 4 0 0 0 9 0 0 0 0 0 0 0 0 0 0 0 0 0 0 0 0 0 0 0 0 0 0 0 1 21 21 2 0 0 0 23 24 24 25 0 0 18 22 4 0 0 0 17 0 0 0 0 1 21 2 0 1 21 2 0 0 0 1 21 2 17 1 21 21 21 7 21 6 5 21 2 0 0 0 0 0 0 0 0 0 0 0 0 18 22 22 22 22 22 22 22 22 22 22 22 22 22 22 22 22 22 
5 21 21 21 21 21 21 21 21 21 2 0 0 0 9 0 0 0 0 0 0 0 0 0 0 0 0 1 21 21 6 5 21 2 0 0 0 0 0 0 0 0 0 18 21 21 21 2 0 0 1 21 21 21 6 4 0 3 5 21 21 21 21 21 7 21 21 21 6 22 22 22 22 22 22 19 0 0 0 0 23 24 24 24 24 25 0 0 0 0 18 22 22 22 22 22 22 22 22 22 22 22 22 22 22 22 22 
22 22 22 22 22 22 22 22 22 22 4 0 23 24 24 24 24 25 0 0 0 0 0 0 11 0 1 21 6 19 17 18 5 21 21 21 21 2 0 0 0 0 0 0 18 22 5 21 21 21 21 22 22 22 5 21 2 0 17 17 17 17 17 17 17 17 17 17 17 17 18 22 22 22 22 4 0 0 0 0 0 0 0 0 0 0 0 0 0 0 0 18 22 22 22 22 22 19 17 17 17 17 17 17 17 18 22 
22 22 22 22 22 22 22 22 22 22 4 0 0 0 0 0 0 0 0 0 0 0 0 1 21 21 21 6 19 0 0 0 17 18 22 22 5 21 2 0 0 0 0 0 0 17 17 17 18 22 22 22 22 22 22 5 21 2 0 0 0 0 1 21 21 21 21 2 0 0 0 17 18 22 22 4 0 0 0 0 0 0 0 0 0 0 0 0 0 0 0 0 18 22 22 22 22 4 0 0 0 0 0 0 0 3 22 
22 22 22 22 22 22 22 22 22 22 4 0 0 0 10 0 0 0 0 0 0 0 1 21 6 19 17 17 0 0 0 0 0 0 17 18 22 5 21 2 0 0 0 0 0 0 0 0 0 17 17 18 22 22 22 22 5 21 2 0 1 21 21 6 22 22 5 21 2 0 0 0 0 17 17 0 0 0 0 0 0 0 0 0 1 21 2 0 0 0 0 0 0 18 22 22 22 4 0 0 0 0 0 0 0 3 22 
22 22 22 22 22 22 22 22 22 22 4 23 24 24 24 25 0 0 0 0 0 1 21 6 19 0 0 15 0 0 0 0 0 23 25 0 17 17 17 0 0 0 0 0 0 9 11 1 21 21 2 0 17 17 17 17 17 17 1 21 21 6 22 22 22 22 22 5 21 2 0 0 0 0 0 0 0 0 23 24 24 24 25 0 3 22 4 0 0 0 0 0 0 0 18 22 22 4 0 0 0 0 0 0 0 3 22 
22 22 22 22 22 22 22 22 22 22 4 0 0 0 0 0 0 0 0 0 1 21 6 5 21 2 0 0 0 0 10 0 0 0 0 0 0 11 0 0 0 0 0 1 21 21 21 21 6 5 21 21 2 0 0 0 0 1 21 6 22 22 22 22 22 22 22 22 5 21 21 2 0 0 0 0 0 0 0 0 0 0 0 0 3 22 4 0 0 0 0 0 0 0 0 17 17 0 0 0 0 0 0 0 0 3 22 
22 22 22 22 22 22 22 22 22 22 4 0 0 0 0 0 0 0 0 1 21 6 22 22 5 21 21 2 9 1 21 21 2 0 9 1 21 21 2 0 23 24 25 3 22 22 22 22 22 22 22 5 21 21 21 21 21 21 6 22 22 22 22 22 22 22 22 22 22 22 22 4 0 0 0 0 0 9 0 0 11 0 0 1 21 7 21 2 0 10 0 0 0 10 0 0 0 0 0 10 11 0 0 9 0 3 22 
22 22 22 22 22 22 22 22 22 22 4 0 0 0 0 0 0 0 1 21 6 22 22 22 22 22 5 21 21 21 6 5 21 21 21 21 6 22 4 0 0 0 0 3 22 22 22 22 22 22 22 22 22 22 22 22 22 22 22 22 22 22 22 22 22 22 22 22 22 22 22 4 0 0 0 0 1 21 21 21 21 21 21 21 6 22 5 21 21 21 21 21 21 21 21 21 21 21 21 21 21 21 21 21 21 21 6 
